1111111111
1300010031
1000000001
1000000001
1000000001
1001000001
1000000001
1000010001
1300000031
1111111111
