1111111111
1302222031
1022002201
1220220221
1202112021
1202112021
1220220221
1022002201
1302222031
1111111111
