1111111111
1302002031
1012222101
1222222221
1002012001
1002102001
1222222221
1012222101
1302002031
1111111111
